XXXXXXXXXXXX
Xa32123132XX
X1X1221XX32X
X31X1213X31X
X23123X22XcX
X1X112X132XX
X2X23131312X
X3231X21231X
X21XX3XX322X
X131XXdXX12X
X12e21Xb231X
XXXXXXXXXXXX